.......................................................................................................................................................................)
.......................................................................................................................................................................)
.......................................................................................................................................................................)
.......................................................................................................................................................................)
.......................................................................................................................................................................)
.......................................................................................................................................................................)
.......................................................................................................................................................................)
.......................................................................................................................................................................)
.......................................................................................................................................................................)
.......................................................................................................................................................................)
.......................................................................................................................................................................)
.......................................................................................................................................................................)
.......................................................................................................................................................................)
.......................................................................................................................................................................)
...............@...........................................############################...#...#......#........#............+..........................+......+.........)
-----------------------------------------------------------------------------------------------------------------------------------------------------------------------)