.........................^^^^^^^^^^^^^^^^^^^^^^^^^^^^^^^^^^^^^^^^^^^^^^^^^^^^^^^^^^^^^^^^^^^^^^^^^^^^^^^^^^^^^^^^^^^^^^^^^^^^^^^^^^^^^^^^^^^^^^^^^^^^^^^^^^^^^^^^^^^^^^)
.......................................................................................................................................................................)
.......................................................................................................................................................................)
.......................................................................................................................................................................)
.......................................................................................................................................................................)
.......................................................................................................................................................................)
.......................................................................................................................................................................)
.......................................................................................................................................................................)
.......................................................................................................................................................................)
.......................................................................................................................................................................)
........................................................................................................0........(......................................................)
...................................................................................................###############################......................................)
...............................................................................................#...%....................................................................)
...........................................................................................#...%...%...................................................................)
...............@.............(..............................############################...%...%...%...#.......(............+..............0............+......+.........)
-----------------------------------------------------------------------------------------------------------------------------------------------------------------------)