.........................^^^^^^^^^^^^^^^^^^^^^^^^^^^^^^^^^^^^^^^^^^^^^^^^^^^^^^^^^^^^^^^^^^^^^^^^^^^^^^^^^^^^^^^^^^^^^^^^^^^^^^^^^^^^^^^^^^^^^^^^^^^^^^^^^^^^^^^^^^^^^^)
.......................................................................................................................................................................)
.......................................................................................................................................................................)
.......................................................................................................................................................................)
.......................................................................................................................................................................)
.......................................................................................................................................................................)
.......................................................................................................................................................................)
.......................................................................................................................................................................)
.......................................................................................................................................................................)
.......................................................................................................................................................................)
.................................................................................................................(......................................................)
...................................................................................................###############################....................................................................)
...............................................................................................#...%....................................................................)
...........................................................................................#...%...%...................................................................)
...............@.............(..............................############################...%...%...%...#.......(............+..........................+......+.........)
-----------------------------------------------------------------------------------------------------------------------------------------------------------------------)