.......................................................................................................................................................................)
.......................................................................................................................................................................)
.......................................................................................................................................................................)
.......................................................................................................................................................................)
.......................................................................................................................................................................)
.......................................................................................................................................................................)
.......................................................................................................................................................................)
.......................................................................................................................................................................)
.......................................................................................................................................................................)
.......................................................................................................................................................................)
.................................................................................................................(......................................................)
...................................................................................................###############################....................................................................)
...............................................................................................#...#....................................................................)
...........................................................................................#...#...#...................................................................)
...............@.............(..............................############################...#...#...#...#.......(............+..........................+......+.........)
-----------------------------------------------------------------------------------------------------------------------------------------------------------------------)