.......................................................................................................................................................................)
.......................................................................................................................................................................)
.......................................................................................................................................................................)
.......................................................................................................................................................................)
.......................................................................................................................................................................)
.......................................................................................................................................................................)
.......................................................................................................................................................................)
.......................................................................................................................................................................)
.......................................................................................................................................................................)
.......................................................................................................................................................................)
.......................................................................................................................................................................)
.................................................................................................................................................................)
...............................................................................................#...#....................................................................)
...........................................................................................#...#...#...................................................................)
...............@...........................................############################...#...#...#...#.......(............+..........................+......+.........)
-----------------------------------------------------------------------------------------------------------------------------------------------------------------------)